##########################################################
##                                                      ##
##                                                      ##
##                     #####################            ##
##              ##########               %%%%%%%%%      ##
##                                                      ##
##                                                      ##
##                                                      ##
##%%%%%%%%%%%%%%%%%%%%%                   %%%%%%%%%%%%%%##
##                                                      ##
##                                                      ##
##                 %%%%%%%%%%%%%%%%%%%%%%%%%%%%%%%%%    ##
##                                                      ##
##       %%%%%%%%%%%%%%                   %%%%%%%%%%%   ##
##                                             %%       ##
##                            %%%%%%%%%%%%%%%%%%%%%%%%% ##
##       %%                                    %%       ##
##       %%         %%%%%%                 %%%%%%%%%%   ##
##                                             %%       ##
##                                             %%       ##
##       %%                                    %%       ##
##                                                      ##
##                                                      ##
##########################################################