###############################
#                             #
#--        -----------      --#
#          +         +        #
#                             #
#                             #
#%%%%%%%%%%%%            %%%%%#
#                             #
#           %%%%%%%%%%%%%%%   #
#                             #
#    %%%%%%%%        %%%%%%%  #
#                             #
#        |              |     #
#    %%%%%%%%        %%%%%%%  #
#                             #
###############################
###############################
###############################